GSGSSWSGWG
SWGSGSGSSW
GGSSWGSS#G
SGSGGSWSSG
GGWGSSSSWS
SGSWSGS#GS
WSSSGSGS#S
S#GGGWGWGW
SSSWGSSGG#
SS#SGWWWWS
S#W#GGG#WG
WW#GSSSSGG
SG#SW##SSW
SSSSS#GS#G
WWSGGGGS#G
WGGSG#SGSW
SGGGGGSGS#
GSSWGSWISS
G#SGGSWGSF
GGSSWWWGSW