GWWSSGWWGGGWGWSSSGWSSWWGWW##SG
G#SSGW#SWWGSGWGGGWSGGS#WGWGG#W
#GGSGGGSG#WSGGGGGGSSWSGW#WG#SG
GSGSWWSWGG#WGSSGSSS#SSSWS##WSW
#G#GSSGWGWSSSGGGGGSGGG#GSGSGGW
SSSGSGSSSS#WSSSGWSSG#WG#WWWW#S
GGGGW#GWSSWSSSGG#WWWW#GGWSGG##
GGSSSGGSGSSSG#WSGSWGSWSSSSSSSG
SSWWGGWSSSGS#SWGGW#GSS#SWG#SG#
WGSGWSSWSGSGG#GWWW#SWGGSW#GWGS
GSSSGWSS#SSWWWGWSGSW#SWS#SWSGG
SGWG#S#WWSGGFWS#WWGSSSGWWWWWGS
WSSSWSSWSSGGSWGGGG#WGSS#WGGGSG
SGG#SSWSWSSWGGSG#GSWSSSS#WSSGS
GWW#GGSWS#GWSGWS#WS#GGSSSGWGWW
GGG#WSWGSWSGWGSGSWWSSGSGGGGW#W
GSGSSSGSGSSSWSGGSGSWS#S#GSSGWG
SGWWG#GGSSSGSGWSWGS#SGSGSGSSGG
GGSGSGSGS#SSSS#SWWGGGS#GSGWWSS
SW#SWG#WGGS#S#GGWGSGWSWSGGWGGG
GGS#GWGSWS##WSSGGWGS#WGGGWGSGW
SWSSSGGWWGWGGS#GGWWGSS#GGGSSWS
GSSG##GGG#SGGWWWSSS#GGWWSGSGSG
GS##SSSWGWGSGSGSWSSGSW#SSWSWGS
#GSGGG#GGWSSGSGSGWSSGGG#SWG##S
WSSGSGGSGGGSGGGGWSS#GSWWG##W#G
G#SSSS#SGGGGGSSSGWGSSSGSWGSGG#
#G##W#SGWGWSS#GWSWWGSWSGSGGSGS
GSGSGWSSWGS#S#WWSWIGWSSGGSGWSW
SSSGGGGSGSWW#SGSG#WSGW#GWSSGSS
WWSGGGGGGWWSGSSS#SWGSSSWSG#SSG
##WGGWGWGGWWSWG##S##SSGWWGSGSG
#SSSWSSSGSW#GWSSSGWWGWGSWWGSGG
GGSGWGW#S#WSGGWSSGGSWGGGGSWS#G
SSSSWSS#SWWSG#GSSSSGSSGWWGGSWG
#SGSSWGSSSGWGWGGGS#SGSSWGSSGGS
GWWGSWSWGWGWGGWSSGSGWGG#SWWGGS
#SGGGWSWSSGWGWGGWGGGGWGWGWSGSG
#S#GWGSGSWGSGS#GWSWS#GSSSSSGGW
GGGGSWGGW#SGGSWGSWSSSSSSSGGSG#
WSGGGGG#GSWWGSG#SSSSSGWWGSGWSS
S#GWGSW#SW#GGSWWGGGWGGGWGSGS##
GGSSWGWS#SGSGWW#WGS#SSGGGS##GW
SGWSGGWSSGG#SWGGSSSWWWGSGGSW#W
GSSWWWSGSWGSGSG##WGW#GSGWGSWGG
SSSGSSS#WWGW#G#W#WSG#G#GSWS#G#
SGWSWGW##SGGGGGSGSWG#GSGS#W#WS
WGSSGSSSSSGSWGSGSW#SWSGGWWGSWG
GSWGGWGWGWGS#G#GS#SGSGWG#SGWWW
GGW#SSWGGSSSSSWGWSWG#SSGSSGGGS