#GGGGGGG#
#WSGGGGF#
#GGWGWWG#
#IGGGGWG#
#GGSSGGG#