GGGGWS#WSW
GSGGWSW#SW
GWSSSSWGGG
#G#WWSSSWW
S#GG#SGSGG
SSSW#G#W#S
#WSWGSISGW
GWSGF#SGGG
SWSSWG#GSS
G#WGSGW#GS